firstName|lastName
Vladimir|Timon
Peter|Isaac
Boris|Quemby
Allen|Erica
Solomon|Nissim
Galvin|Faith
Oliver|Bert
Caesar|Nathan
Holmes|Kirsten
Branden|Mikayla
Deacon|Hilda
Jeremy|Chaim
Derek|Fredericka
Caldwell|Nerea
Brett|Daria
Len|Ferris
Giacomo|Axel
Salvador|Miriam
Jakeem|Dawn
Salvador|Macaulay
Edward|Christen
Griffin|Leroy
Cullen|Micah
Robert|Dolan
Graham|Timothy
Ivan|Stella
Berk|Paloma
Magee|Lesley
Orlando|Erica
Keith|Aline
Raja|Dylan
Gil|Kato
Nissim|Gisela
Lionel|Barry
Mannix|Brittany
Omar|Lavinia
Lewis|Phillip
Randall|Signe
Demetrius|Blake
Tarik|Cameron
Lyle|Lev
Xavier|Priscilla
Xanthus|Melanie
Richard|Amaya
Acton|Jael
Lucas|Ann
Lionel|Eleanor
Alec|Geraldine
Harding|Hu
Nero|Rafael
Dexter|Aidan
Orlando|Prescott
Arsenio|Rina
Caldwell|Quail
Xander|Elmo
Omar|Amanda
Beau|Vincent
Nero|Samuel
Arthur|Cole
Tarik|Ginger
Rudyard|Mechelle
Harper|Castor
Baker|Marah
Jack|Renee
Hasad|Inez
Jarrod|Eric
Logan|Zephania
Colton|Fiona
Reuben|Jason
Gray|Jada
Reuben|Eagan
Plato|Isaiah
Roth|Rafael
Levi|Clinton
Kelly|Herrod
Ryan|Lester
Wing|Stephen
Zahir|Maile
Jarrod|Shaeleigh
Byron|Halla
Xander|Freya
Judah|Len
Burke|Yuli
Nigel|Rajah
Hyatt|Hayley
Walker|Erich
Tucker|Ashton
Thor|Claire
Erich|Justin
Colorado|Teagan
Scott|Yetta
Jelani|Martha
Michael|Stella
Chase|Erich
Dustin|Nell
Carlos|Irene
Grant|Christen
Isaac|Ishmael
John|Driscoll
Vincent|Garrison